                                                                                                                                                                                                                                                                                                                                                                                                                                                                                                                                                                                                                                                                  §
                                                                                                                                                                                                                                                             ^                                                                                                                                                                                                                                                                                                                                                                                                    §
         ^^^^^^^^^                                                                      @@     @@@                                            @@                                                                                                             1                                                                                                                                                                                                                                                                                                                          @@                                                                        §                                                                                                                                                                                                                                                §[=]   x3    [=][=][=][=][=][=][=]            [
         | [] [] |                                          @@                                  @@@                                                    @@@                                                                             @@        @@@        -|                                @@    @@@                                                                              @@        @@@                                         @@  @@@                                                       x2                         @@         @@@                                        [T][T] @@@                     |7                                 @@    §                                                                                                    $  $  $                                                        $                                                                            §[=]                                          [
      ^^^^^^^^^^^^^^^                                                                                                                                   @@@                                                   @@                                  @@@        |-                                      @@@                                                  @@                                    @@@                                             @@@                                                      @@                                     @@@                                       [T][T]  @@@                    |                                        §                                                                                                                $  $  $  $  $  $  $  $  $  $  $  $  $  $  $  $                                                                                  §[=]                                          [
      |     /^\     |                                                                  [g][=][=][=]                                                               [$][$][$][$][$]                                 [*][=][=][=]                        [=][=][|][=][=]                  [=][=][=][=]                                                                                    [S][=][=][=]                                                                                                         [=][=][=][=][=]         [s]                                                   [T][T]                         |                                        §                                              $  $  $  $  $  $  $  $  $  $  $  $  $  $  $  $  $                                                                                                                                                 §[=]             $  $  $  $  $                [
      |     | |     |                                                       g                                                                                                                                                                                                                                                                                                                                                                                                                                                                                                             [T][T]                         |                                        §                                                                                                                                                                                                                                                §[=]                                          [
^^^^^^^^^^^^^^^^^^^^^^^^^^^                                                                                                                                                                                                                                                                                                                                                                                                                                                                                                                                                               [T][T]                         |                                        §                                                                                                                                                                                                                                                §[=]          $  $  $  $  $  $  $             [
|        /^\   /^\        |                                                [T]                                                                                           b                                                                                                                                               ge3                                                                          [[[]]]                                                                                                                                                                              [T][T]                         |             ^^^^^^^^^                  §            xa                                                                                                                                                                                                                                  §[=]                                          [
|        |_|   |_|        |                        [=][S][=]            [T][T]         [O]               [T]                                 [[[]]]               [s][$][$][$][$]                              [=]               [[[]]]         [$][$][$][$]      [$][$][$]                                             [[[]]]                                                [[[]]]                  [    ]                                                                                       [£]                        [$]                                                         [T][T]                         |             | [] [] |                  §            -|                                  =@=@=@=@=                                                                                                                                                                                       §[=]          $  $  $  $  $  $  $             [
|                         |                   8                    8 [T][T][T]                           [T]                                 [    ]                                        8                       8             [    ]                                                                                 [    ]          8                  x4g  8             [    ]      [[[]]]      [    ]                                                                  [T]       8                       8                               [[[]]]                            8       [T][T]                         |          ^^^^^^^^^^^^^^^               §             |-                                         >                                                                                                                                                                                       §[=]         [=][=][=][=][=][=][=]            [
|     /^\   /^\   /^\     |             8     8                   [T][T][T][T]                           [T][T]             8        8       [    ]                                  8     8                       8     8  8    [    ]                                     8        8                                  [    ]          8                [[[]]] 8     8  8    [    ]      [    ]      [    ]             8                                                    [T] 8     8                       8     8  8                      [    ]                   8        8 ZZZ   [T][T]                         |        8 |     /^\     |               §            -|                                                                                                                                                                                                                                  §[=]         [=][=][=][=][=][=][=]      ]=====[
|     | |   |M|   | |     |             |     | =|==|==|==|=   [T][T][T][T][T]                      b  b [T][T]      =|==|= | =|= g  | g     [    ]                                  |     | =|==|==|==|=b       g | g  g|  |    [    ]                              =|==|=g|g=|=g   |                                  [    ]          | =|==|==|==|=   [    ] |     | g|    [    ]      [    ]      [    ]      =|==|= | =|=b                                       b'      [T] |     | =|==|==|==|= g   g    |     |  |  b'    b'            [    ]            =|==|= |b=|=    | \-/   [T][T]                        [T]       | |     |X|     |=|=            §             |-                                                                                                                                                                                                 $  $  $                         §[=]         [=][=][=][=][=][=][=]    e4]=====[
[#][#][#][#][#][#][#][#][#][#][#][#][#][#][#][#][#][#][#][#][#][#][#][#][#][#][#][#][#][#][#][#][#][#][#][#][#][#][#][#][#][#][#][#][#][#][#][#][#][#][#][#][#][#][#][#][#][#][#][#][#][#][#][#][#][#][#][#][#][#][#][#][#][#][#][#][#][#][#][#][#][#][#][#][#][#][#][#][#][#][#][#][#]            [#][#][#][#][#][#][#][#][#][#]      [#][#][#][#][#][#][#][#][#][#][#][#][#][#][#][#][#][#][#][#][#][#][#][#][#][#][#][#][#][#]         [#][#][#][#][#][#][#][#][#][#]      [#][#][#][#][#][#][#][#][#][#][#][#][#][#][#][#][#][#][#][#][#][#][#][#][#][#][#][#][#][#][#][#][#][#][#][#][#][#][#][#][#][#][#][#][#][#][#][#][#][#][#][#][#][#][#][#][#][#][#][#]§[@][@][@][@]-| [@][@][@][@][@][@][@][@][@][@][@][@][@][@][@][@][@][@][@][@][@][@][@][@][@][@][@][@][@][@][@][@][@][@][@][@][@][@][@][@][@][@][@][@][@][@][@][@][@][@][@][@][@][@][@][@][@]  -e2-                                                §[#][#][#][#][#][#][#][#][#][#][#][#][#][#][#][#]
[#][#][#][#][#][#][#][#][#][#][#][#][#][#][#][#][#][#][#][#][#][#][#][#][#][#][#][#][#][#][#][#][#][#][#][#][#][#][#][#][#][#][#][#][#][#][#][#][#][#][#][#][#][#][#][#][#][#][#][#][#][#][#][#][#][#][#][#][#][#][#][#][#][#][#][#][#][#][#][#][#][#][#][#][#][#][#][#][#][#][#][#][#]            [#][#][#][#][#][#][#][#][#][#]      [#][#][#][#][#][#][#][#][#][#][#][#][#][#][#][#][#][#][#][#][#][#][#][#][#][#][#][#][#][#]         [#][#][#][#][#][#][#][#][#][#]      [#][#][#][#][#][#][#][#][#][#][#][#][#][#][#][#][#][#][#][#][#][#][#][#][#][#][#][#][#][#][#][#][#][#][#][#][#][#][#][#][#][#][#][#][#][#][#][#][#][#][#][#][#][#][#][#][#][#][#][#]§             |-                                                                                                                                                                                                                                 §[#][#][#][#][#][#][#][#][#][#][#][#][#][#][#][#]
